11111111
100EC001
1N0000P1
11111111
