11111111111111111111
1CCCC1CCCCCCCC1CCCC1
1C11C1C111111C1C1EC1
1C1000000000000000C1
1C1C11C110011C11C1C1
1C1C11C111111C11C1C1
1C1CCCCC0P0CCCCC01C1
1011010111110000N001
10000100000000100001
11111111111111111111
