1111111111111111111111111111111111
1E00000000000N0C00000C000000000001
101001010010000010100100N000010101
10100100101010100010010N0000010101
1P0000000C00C000000000000000N000C1
1111111111111111111111111111111111
